WallSizeWidth,WallSizeHeight,SortLayer,,,,,,,,,,,,
15,15,-1,,,,,,,,,,,,
,,,,,,,,,,,,,,
,,,,,,,,,,,,,,
"11,-1","10,-1","10,-1","10,-1","10,-1","10,-1","10,-1","10,-1","10,-1","10,-1","10,-1","10,-1","10,-1","10,-1","12,-1"
"11,-1","8,16","8,-1","8,-1","8,-1","8,-1","8,16","8,-1","8,-1","8,-1","8,-1","8,-1","8,-1","8,16","12,-1"
"11,-1","8,-1","8,-1","8,-1","8,-1","8,-1","8,-1","8,-1","8,-1","8,-1","8,-1","8,-1","8,-1","8,-1","12,-1"
"11,-1","8,-1","8,-1","8,-1","8,-1","8,-1","8,-1","8,-1","8,-1","8,-1","8,-1","8,-1","8,-1","8,-1","12,-1"
"11,-1","8,-1","8,-1","8,-1","8,-1","8,-1","8,-1","8,-1","8,-1","8,-1","8,-1","8,-1","8,-1","8,-1","12,-1"
"11,-1","8,-1","8,-1","8,-1","8,-1","8,-1","8,-1","8,-1","8,-1","8,-1","8,-1","8,-1","8,-1","8,-1","12,-1"
"11,-1","8,16","8,-1","8,-1","8,-1","8,-1","8,-1","8,-1","8,-1","8,-1","8,-1","8,-1","8,-1","8,16","12,-1"
"11,-1","8,-1","8,-1","8,-1","8,-1","6,-1","8,-1","6,-1","6,-1","6,-1","6,-1","8,-1","8,-1","8,-1","12,-1"
"11,-1","8,-1","8,-1","8,-1","8,-1","6,-1","7,-1","6,-1","6,-1","8,-1","6,-1","8,-1","8,-1","8,-1","12,-1"
"11,-1","8,-1","8,-1","8,-1","8,-1","8,-1","7,-1","6,-1","6,-1","6,-1","8,-1","8,-1","8,-1","8,-1","12,-1"
"11,-1","8,-1","8,-1","8,-1","8,-1","8,-1","8,-1","8,-1","8,-1","8,-1","8,-1","8,-1","8,-1","8,-1","12,-1"
"11,-1","8,-1","8,-1","8,-1","8,-1","8,-1","8,-1","8,-1","8,-1","8,-1","8,-1","8,-1","8,-1","8,-1","12,-1"
"11,-1","8,-1","8,-1","8,-1","8,-1","8,-1","8,-1","8,-1","8,-1","8,-1","8,-1","8,-1","8,-1","8,-1","12,-1"
"11,-1","8,16","8,-1","8,-1","8,-1","8,-1","8,-1","8,-1","8,-1","8,-1","8,-1","8,-1","8,-1","8,16","12,-1"
"14,-1","-1,13","-1,13","-1,13","-1,13","-1,13","-1,13","-1,13","-1,13","-1,13","-1,13","-1,13","-1,13","-1,13","15,-1"
