3,0,0,0,0,0,0,0,0,0,4
3,6,6,6,6,6,6,6,6,6,4
3,6,6,6,6,6,6,6,6,6,4
3,6,6,6,6,6,6,6,6,6,4
3,6,6,6,6,6,6,6,6,6,4
3,6,6,6,6,6,6,6,6,6,4
3,6,6,6,6,6,6,6,6,6,4
3,6,6,6,6,6,6,6,6,6,4
3,6,6,6,6,6,6,6,6,6,4
3,6,6,6,6,6,6,6,6,6,4
-1,5,5,5,5,5,-1,-1,5,5,-1
