1,0,0,0,0,0,0,0,0,0,2
1,4,4,4,4,4,4,4,4,4,2
1,4,4,4,4,4,4,4,4,4,2
1,4,4,4,4,4,4,4,4,4,2
1,4,4,4,4,4,4,4,4,4,2
1,4,4,4,4,4,4,4,4,4,2
1,4,4,4,4,4,4,4,4,4,2
1,4,4,4,4,4,4,4,4,4,2
1,4,4,4,4,4,4,4,4,4,2
1,4,4,4,4,4,4,4,4,4,2
1,3,3,3,3,3,3,3,3,3,2
